TOP TEN shortkeys mas usados	http://stackoverflow.com/questions/98606/favorite-visual-studio-keyboard-shortcuts	

ctrl ,	navegar	1
alt I  /  F3	busq incremental	2
WINDOWS + tab	cambio ventana windows	
ALT A + E + Y	new query	
ctrl K D	indentar	
ctrl TAB (el ctrl con el pulgar derecho)	cambio ventana (no solo de codigo!)	usarlo mas
ctrl W K	Lista de bookmarks	
ctrl W E	errores	
ctrl shift F4	next error	
	Reopen last closed tab in visual studio 	
shft F2	ir a definicion	
(ctrl) shft  -	ultimo lugar	
ctrl shift F	busq en todo	3
http://stackoverflow.com/questions/1535469/how-to-quickly-edit-values-in-table-in-sql-server-management-studio		
" 'TODO " , ctrl alt K	agregar tarea, ver tareas	usarlo mas
" CTRL + ]    
(Edit.GotoBrace) "	matching brace	
TAB x 2	snippet	
ctrl G	inmediato	
F7	toggle markup/code	
????????????	model browser	
ctrl R	project explorer	
		
ctrl alt E	break en toda excepcion	
ctrl K T,  ctrl K N	bookmarks. toogle y next	
 Alt+ W, L	cerrar todo	
sp_help sp_helptext		
	pegar como comentario	
Tools>Options...>Projects and Solutions>General>"Track active item in Solution Explorer"	sincronizar solution explorer	
ctrl alt S	server explorer	
	buscar en el server explorer (en SQL)	
	buscar activo en el solution explorer	
ctrl alt K	task list	
ctrl shift F9	sacar breaks	
ctrl shift E	ejec sql en vstudio	